Age,NoofLoans,GoodLoans,BadLoans,GoodRatio,BadRatio
22,400,390,10,97.5,2.5
23,503,480,23,95.4,4.6
24,15000,14800,200,98.7,1.3
25,2500,2457,43,98.3,1.7
26,8000,7763,237,97,3
27,9000,8544,456,94.9,5.1
28,7000,6740,260,96.3,3.7
29,6000,5700,300,95,5
30,5050,4752,298,94.1,5.9
31,6408,6372,36,99.4,0.6
32,4568,4493,75,98.4,1.6
33,2346,2283,63,97.3,2.7
34,500,484,16,96.8,3.2
